00000000000000000000000000000000
0a 0 7 1 2 1 1 a 1 4 2 2 7 4 3 0
01 7 a 9 5 6 8 a 1 2 3 3 a 9 1 0
0                              0
05 7 a 5 5 5 5 5 5 5 5 5 a 5 5 0
04 7 4 a 4 4 4 4 4 4 4 4 7 4 4 0
03 7 a 3 3 3 3 3 3 3 3 3 7 a 3 0
01 7 1 1 1 1 1 1 1 1 1 1 7 1 1 0
0                              0
0                              0
0                              0
0                              0
0                              0
0                              0
0                              0
0                              0
0                              0
0                              0
0                              0
0                              0
0                              0
0                              0
0                              0
0                              0
0                              0
0                              0
0                              0
0                              0
0                              0
0                              0 